8 0 0 0 0 0 0 0 0 0 0 0 0 0 0 7
8 0 0 0 0 0 0 0 0 0 0 0 0 0 0 7
8 0 0 0 0 0 0 0 0 0 0 0 0 0 0 7
8 1 1 1 1 1 1 1 3 0 0 0 0 0 0 7
8 0 0 0 0 0 0 0 0 0 0 0 0 0 0 7
8 0 0 0 0 0 0 0 0 0 0 0 0 0 0 7
8 0 0 0 0 0 0 0 0 0 0 0 0 0 0 7
8 4 4 4 4 4 4 4 4 0 0 0 0 0 0 7
8 0 0 0 0 0 0 0 0 0 0 0 0 0 0 7
8 0 0 0 0 0 0 0 0 0 0 0 0 0 0 7
8 0 0 0 0 0 0 0 0 0 0 0 0 0 0 7
8 4 4 4 4 4 4 4 4 4 4 4 4 4 4 7



