8 0 0 0 0 0 0 0 0 0 0 0 0 0 0 7
8 0 0 0 0 0 0 0 0 0 0 0 0 0 0 7
8 0 0 0 0 0 0 0 0 0 0 0 0 0 0 7
8 4 4 4 4 4 4 4 6 0 0 0 0 0 0 7
8 0 0 0 0 0 0 0 0 0 0 0 0 0 0 7
8 0 0 0 0 0 0 0 0 5 4 4 4 4 4 7
8 0 0 0 0 0 0 0 0 0 0 0 0 0 0 7
8 4 4 4 4 4 4 4 6 0 0 0 0 0 0 7
8 0 0 0 0 0 0 0 0 0 0 0 0 0 0 7
8 0 0 0 0 0 0 0 0 5 4 4 4 4 4 7
8 0 0 0 0 0 0 0 0 0 0 0 0 0 0 7
8 4 4 4 4 4 4 4 4 4 4 4 4 4 4 7



